Level 1
#########
#   .   #
#       #
#   $   #
#       #
#   @   #
#########