Level 1
#########
#   .   #
#       #
#   $   #
#       #
#       #
#   @   #
#       #
#########